date,orders,new_orders,new_customers,total_revenue,gross_profit,COGS
2024-01-01,145,89,72,12900,5160,7740
2024-01-02,158,95,78,14220,5688,8532
2024-01-03,132,81,65,11880,4752,7128
2024-01-04,167,102,85,15030,6012,9018
2024-01-05,189,114,95,17010,6804,10206
2024-01-06,128,78,63,11520,4608,6912
2024-01-07,174,106,88,15660,6264,9396
2024-01-08,196,119,99,17640,7056,10584
2024-01-09,142,87,71,12780,5112,7668
2024-01-10,205,124,103,18450,7380,11070